##########
#OOP   ###
#  # XX ##
#       ##
##########
##########
##########
##########
##########
##########