##########
#P #OO####
#     ####
# X X ####
#   # ####
#####  ###
#####  ###
##########
##########
##########