##########
##########
####PO####
####X ####
####  ####
#### X####
####O ####
####  ####
##########
##########