##########
#  #######
#O #######
# XP######
# X ######
#O #######
##########
##########
##########
##########