##########
#####   ##
##PX  # ##
##O X  O##
##########
##########
##########
##########
##########
##########